@@@#####@@@@
@##########@
@##########@
@##########@
############
#####@######
####@@@#####
#####@######
############
@##########@
@##########@
@@@#####@@@@