@@@@@@@@@@
@#@######@
@#@#@@@@#@
@#@#@##@#@
@#@#@@#@#@
@#@#@@#@#@
@#@####@#@
@#@@@@@@#@
@########@
@@@@@@@@@@