@@@@@@@@@@
@#######@@
@#####@##@
@####@@@#@
@###@@#@#@
@#@#@@###@
@#@@@####@
@##@#####@
@@#######@
@@@@@@@@@@